Party,N. repr.,A,N,0,Z,M,Meeting,Proposal
ANO,78,39,0,0,0,39,40,48
ODS,23,12,0,0,0,11,40,48
Piráti,22,11,0,0,0,11,40,48
SPD,19,10,0,0,0,9,40,48
ČSSD,14,6,0,0,0,8,40,48
KSČM,15,7,0,0,0,8,40,48
KDU-ČSL,10,5,0,0,0,5,40,48
TOP09,7,3,0,0,0,4,40,48
STAN,6,2,0,0,0,4,40,48
Nezařaz,6,2,0,0,0,4,40,48
Celkem,200,97,0,0,0,103,40,48
