Party,N. repr.,A,N,0,Z,M,Meeting,Proposal
ANO,78,32,0,0,0,46,42,11
ODS,23,10,0,0,0,13,42,11
Piráti,22,10,0,0,0,12,42,11
SPD,20,6,0,0,0,14,42,11
ČSSD,14,4,0,0,0,10,42,11
KSČM,15,5,0,0,0,10,42,11
KDU-ČSL,10,4,0,0,0,6,42,11
TOP09,7,2,0,0,0,5,42,11
STAN,6,1,0,0,0,5,42,11
Nezařaz,5,0,0,0,0,5,42,11
Celkem,200,74,0,0,0,126,42,11
