Party,N. repr.,A,N,0,Z,M,Meeting,Proposal
ANO,78,39,0,0,0,39,57,118
ODS,23,11,0,0,0,12,57,118
Piráti,22,11,0,0,0,11,57,118
SPD,19,8,0,0,0,11,57,118
ČSSD,14,5,0,0,0,9,57,118
KSČM,15,6,0,0,0,9,57,118
KDU-ČSL,10,4,0,0,0,6,57,118
TOP09,7,3,0,0,0,4,57,118
STAN,6,3,0,0,0,3,57,118
Nezařaz,6,0,0,0,0,6,57,118
Celkem,200,90,0,0,0,110,57,118
