Party,N. repr.,A,N,0,Z,M,Meeting,Proposal
ANO,78,34,0,0,0,44,59,1
ODS,23,6,0,0,0,17,59,1
Piráti,22,9,0,0,0,13,59,1
SPD,19,10,0,0,0,9,59,1
ČSSD,14,3,0,0,0,11,59,1
KSČM,15,4,0,0,0,11,59,1
KDU-ČSL,10,6,0,0,0,4,59,1
TOP09,7,3,0,0,0,4,59,1
STAN,6,3,0,0,0,3,59,1
Nezařaz,6,3,0,0,0,3,59,1
Celkem,200,81,0,0,0,119,59,1
