Party,N. repr.,A,N,0,Z,M,Meeting,Proposal
ANO,78,39,0,0,0,39,60,29
ODS,23,10,0,0,0,13,60,29
Piráti,22,11,0,0,0,11,60,29
SPD,19,9,0,0,0,10,60,29
ČSSD,14,6,0,0,0,8,60,29
KSČM,15,8,0,0,0,7,60,29
KDU-ČSL,10,5,0,0,0,5,60,29
TOP09,7,3,0,0,0,4,60,29
STAN,6,2,0,0,0,4,60,29
Nezařaz,6,1,0,0,0,5,60,29
Celkem,200,94,0,0,0,106,60,29
